SSSSSSSSSSSSSSSSSSSSSSSSSSSSSSSSSSSSSSSS
S000000000000000000SS000000000000000000S
S000000000000000000SS000000000000000000S
S000000000000000000SS000000000000000000S
S000000000000000000SS000000000000000000S
S000000000000000000SS000000000000000000S
S000000P00000000000SS000000000000000000S
S000000000000000000SS000000000000000000S
S000000000000000000SS000000000000000000S
S000000000000000000SS000000000000000000S
S000000000000000000SS000000000000000000S
S000000000000000000SS000000000000000000S
S000000000000000000SS000000000000000000S
S000000000000000000SS000000000000000000S
SSSSSSSSSSS0SSSSSSSSSSSSSSSSSSS0SSSSSSSS
SSSSSSSSSSS0SSSSSSSSSSSSSSSSSSS0SSSSSSSS
S000000000000000000SS000000000000000000S
S000000000000000000SS000000000000000000S
S000000000000000000SS000000000000000000S
S000000000000000000SS000000000000000000S
S000000000000000000SS000000000000000000S
S00000000000000000000000000000000000000S
S000000000000000000SS000000000000000000S
S000000000000000000SS000000000000000000S
S000000000000000000SS000000000000000000S
S000000000000000000SS000000000000000000S
S000000000000000000SS000000000000000000S
S000000000000000000SS000000000000000000S
SSSSSSSSSSSSSSSSSSSSSSSSSSSSSSSSSSSSSSSS