SSSSSSSSSSSSSSSSSSSSSSSSSSSSSSSSSSSSSSSSSSSSSSSSSSSSSSSSSSSSSSSSSSSSSSSSSSSSSSSSSSSSSSSSSSSSSSSSSSSSSSSSSSSSSSSSSSSSS0SS0SS0SSSSSSSSSSSSSSSSSSSSSSSSSSSSSSSSS
SSSSSSSSSSSSSSSSSSSSSSSSSSSSSSSSSSSSSSSS00001111111100111000000000000000000000000000000000000000SSSSSSSSSSSSSSSSSSSSS0SS0SS0SSSSSSSSSSSSSSSSSSS0000000000000S
SS00000000000000000SSSSSSSSSSSSSSSSSSSSS00111111111100111SSSSSSSSSSSSSSSSSSSSSSSSSSS000000000000SSSSSSSSSSSSSSSSSSSSS0SS0SS0SSSSSSSSSSSSSSSSSSS0000000000000S
SS00000000000000000SSSSSSSSSSSSSSSSSSS0S11111110001100110SSSSSSSSSSSSSSSSSSSSSSSSSSS000000000000SSSSSSSSSSSSSSSSSSSSS0SS0SS0SSSSSSSSSSSSSSSSSSS0000000000000S
SS00000000000000000SSSSSSSSSSSSSSSSSSS0011110001111100110SSSSSSSSSSSSSSSSSSSSSSSSSSS000000000000SSSSSSSSSSSSSSS000000000000000000000000000000000000000000000S
SS00000000000000000SSSSSSSSSSSSSSSSSSS0S11110001111100110SSSSSSSSSSSSSSSSSSSSSSSSSSS000000000000SSSSSSSSSSSS0SS0SSSSSSSSSSSSSSSSSSSSSSSSSSSSSSS0000000000000S
SS00000000000000000SSSSSSSSSSSSSSSSSSS0S00001111100001110SSSSSSSSSSSSSSSSSSSSSSSSSSS0000000000000000000000000000SSSSSSSSSSSSSSSSSSSSSSSSSSSSSSS0000000000000S
SS0000000P000000000S00000000SSSSSSSSSS0S11111111100001110SSSSSSSSSSSSSSSSSSSSSSSSSSS000000000000SSSSSSSSSSSSSSSSSSSSSSSSSSSSSSSSSSSSSSSSSSSSSSS0000000000000S
SS00000000000000000SSSSSSSS0SSSSSSSSSS0S11111100000001100SSSSSSSSSSSSSSSSSSSSSSSSSSS000000000000SSSSSSSSSSSSSSSSSSSSSSSSSSSSSSSSSSSSSSSSSSSSSSS0000000000000S
SS00000000000000000SSSSSSSS000000000000S11100000011111100SSSSSSSSSSSSSSSSSSSSSSSSSSS000000000000SSSSSSSSSSSSSSSSSSSSSSSSSSSSSSSSSSSSSSSSSSSSSSS0000000000000S
SS00000000000000000SSSSSSSSSSSSSSSSSSSSS01100000011111100SSSSSSSSSSSSSSSSSSSSSSSSSSS000000000000SSSSSSSSSSSSSSSSSSSSSSSSSSSSSSSSSSSSSSSSSSSSSSSSSSSSSS0SSSSSS
SS00000000000000000SSSSSSSSSSSSSSSSSSSSS11100000011000000SSSSSSSSSSSSSSSSSSSSSSSSSSS000000000000SSSSSSSSSSSSSSSSSSSSSSSSSSSSSSSSSSSSSSSSSSSSSSSSSSSSSS0SSSSSS
SS00000000000000000SSSSSSSSSSSSSSSSSSSSS11111111111000000SSSSSSSSSSSSSSSSSSSSSSSSSSS000000000000SSSSSSSSSSSSSSSSSSSSSSSSSSSSSSSSSSSSSSSSSSSSSSSSSSSSSS0SSSSSS
SSSSSSSSSSSSSSSSSSSSSSSSSSSSSSSSSSSSSSSS11111111111000000SSSSSSSSSSSSSSSSSSSSSSSSSSS000000000000SSSSSSSSSSSSSSSSSSSSSSSSSSSSSSSSSSSSSSSSSSSSSSSSSSSSSS0SSSSSS
SSSSSSSSSSSSSSSSSSSSSSSSSSSSSSSSSSSSSSSSSSSSSSSSSSSSSSSSSSSSSSSSSSSSSSSSSSSSSSSSSSSSSSSSSSSSSSSSSSSSSSSSSSSSSSSSSSSSSSSSSSSSSSSSSSSSSSSSSSSSSSSSSSSSSS0SSSSSS