SSSSSSSSSSSSSSSSSSSSSSSSSSSSSSSSSSSSSSSSSSSSSSSSSSSSSSSSSSSSSSSSSSSSSSSSSSSSSSSSSSSSSSSSSSSSSSSSSSSSSSSSSSSSS
S000000000000000000SSSSSSSSSSSSSS000000000000SSSSSSSSSSSSS000000000000000000000000000000000SSSSSSSSS00000000S
S000000000000000000SSSSSSSSSSSSS00000000000000SSSSSSSSSSSS00SSSSSSSSSSSSSSSSSSSSSSS00000000SSSSSSSSS000000SSS
S000000000000000000SSSSSSSSSSSS0000000000000000SSSSSSSSSSS00000000000SSSSSSSSSSSSSS00000000SSSSSSSSS0000SSSSS
S000000000000000000SSSSSSSSSSS000000000000000000SSSSSSSSSSSSSSSSSS000SSSSSSSSSSSSSS00000000SSSSSSSSS000SSSSSS
S000000000000000000SSSSSSSSSSS000000000000000000SSSSSSSS0S0000000S000SSSSSSSSSSSSSS00000000SSSSSSSSS00SSSSSSS
S000000000000000000SSSSSSSSSSS00000000000000000000000000000000000S00000SSSSSSSSSSSS00000000SSSSSSSSS0SSSSSSSS
S00000000000000000000000000000000000000000000000SSSSSSSSSS0000000SSSSS0SSSSSSSSSSSS000000000000000000SSSSSSSS
S000000P00000000000SSSSSSSSSSS000000S0SS00000000SSSSSSSSSS0000000S00000SSSSSSSSSSSS00000000SSSSSSSSS00SSSSSSS
S000000000000000000SSSSSSSSSSS000000000000000000SSSSSSSSSSSSSSS00S00000SSSSSSSSSSSSSSSSSSSSSSSSSSSSS000SSSSSS
S000000000000000000SSSSSSSSSSS000000000000000000SSSSSSSSSS0000000S00SSSSSSSSSSSSSSSSSSSSSSSSSSSSSSSS0000SSSSS
S000000000000000000SSSSSSSSSSS00000000000000000SSSSSSSSSSS0000000S00SS00SSSSSSSSSSSSSSSSSSSSSSSSSSSS00000SSSS
S000000000000000000SSSSSSSSSSSS000000000000000SSSSSSSSSSSS00SSSSSS00000SSSSSSSSSSSSSSSSSSSSSSSSSSSSS000000SSS
S000000000000000000SSSSSSSSSSSSS0000000000000SSSSSSSSSSSSS00000000000000SSSSSSSSSSSSSSSSSSSSSSSSSSSS000000000
SSSSSSSSSSSSSSSSSSSSSSSSSSSSSSSSSSSSSSSSSSSSSSSSSSSSSSSSSSSSSSSSSSSSSSSSSSSSSSSSSSSSSSSSSSSSSSSSSSSSSSSSSSSSS