SSSSSSSSSSSSSSSSSSSSSSSSSSSSSSSSSSSSSSSSSSSSSSSSSSSSSSSSSSSSSSSSSSSSSSSSSSSSSSSSSSSSSSSSSSSSSSSSSSSSSSSSSSSSSSSSSSSSSSSSSSSSSSSSSSSSSSSSSSSSSS
S000000000000000000SSSSSSSSSSSSSSSSSSSSS000000000000000000SSSSSSSSSSSSSSSSSSSSSSSSSSSS0SSSSSSS0000000000111111000SSSSSSSSSSSSSSS0000000000000S
S000000000000000000SSSSSSSSSSSSSSSSSSSSS000000000000000000SSSSSSSSSSSSSSSSSSSSSSSSSSS00SSSSSSS0000000000111111000SSSSSSSSSSSSSSS0000000000000S
S000000000000000000SSSSSSSSSSSSSSSSSSSSS000000000000000000SSSSSSSSSSSSSSSSSSSSSSSSSS000SSSSSSS0000000000110011000SSSSSSSSSSSSSSS0000000000000S
S000000000000000000SSSSSSSSSSSSSSSSSSSSS000000000000000000SSSSSSSSSSSSSSSSSSSSSSSSS0000SSSSSSS1111111100110011000SSSSSSSSSSSSSSS0000000000000S
S000000000000000000SSSSSSSSSSSSSSSSSSSSS000000000000000000SSSSSSSSSSSSSSSSSSSSSSSS00000SSSSSSS1111111100110011000SSSSSSSSSSSSSSS0000000000000S
S000000000000000000SSSSSSSSSSSSSSSSSSSSS000000000000000000SSSSSSSSSSSSSSSSSSSSSSS000000SSSSSSS1110001100110011011SSSSSSSSSSSSSSS00000000000SSS
S000000000000000000SSSSSSSSSSSSSSSSSSSSS000000000000000000000000000000000000SSSS0000000SSSSSSS11100011001100110110000000000000000000000000000S
S0000P0000000000000SSSSSSSSSSSSSSSSSSSSS000000000000000000SSSSSSSSSSSSSSSSS0SSS00000000SSS0SSS1110001100110011011SSSSSSSSSSSSSSS00000000000SSS
S000000000000000000SSSSSSSSSSSSSSSSSSSSS000000000000000000SSSSSSSSSSSSSSSSS0SS00000000000000001110111100110011011SSSSSSSSSSSSSSS0000000000000S
S000000000000000000SSSSSSSSSSSSSSSSSSSSS000000000000000000SSSSSSSSSSSSSSSSS0S0000000000SSSSSSSSSSS111100110011011SSSSSSSSSSSSSSS0000000000000S
S000000000000000000000000000000000000000000000000000000000SSSSSSSSSSSSSSSSS000000000000SSSSSSSSSSS110000110011011SSSSSSSSSSSSSSS0000000000000S
S000000000000000000SSSSSSSSSSSSSSSSSSSSS000000000000000000SSSSSSSSSSSSSSSSSSS0000000000SSSSSSSSSSS111111110011111SSSSSSSSSSSSSSS0000000000000S
S000000000000000000SSSSSSSSSSSSSSSSSSSSS000000000000000000SSSSSSSSSSSSSSSSSSSS000000000SSSSSSSSSSS111111110011111SSSSSSSSSSSSSSS0000000000000S
SSSSSSSSSSSSSSSSSSSSSSSSSSSSSSSSSSSSSSSSSSSSSSSSSSSSSSSSSSSSSSSSSSSSSSSSSSSSSSSSSSSSSSSSSSSSSSSSSSSSSSSSSSSSSSSSSSSSSSSSSSSSSSSSSSSSSSSSSSSSSS