SSSSSSSSSSSSSSSSSSSSSSSSSSSSSSSSSSSSSSSSSSSSSSSSSSSSSSSSSSSSSSSSSSSSSSSSSSSSSSSSSSSSSSSS
S000000000000000000SSSSSSSSSSSSSSSSSSSSS000000000000000000SSSSSSSSSSSSSSSSSSSSSSSSSSSS0S
S000000000000000000SSSSSSSSSSSSSSSSSSSSS000000000000000000SSSSSSSSSSSSSSSSSSSSSSSSSSS00S
S000000000000000000SSSSSSSSSSSSSSSSSSSSS000000000000000000SSSSSSSSSSSSSSSSSSSSSSSSSS000S
S000000000000000000SSSSSSSSSSSSSSSSSSSSS000000000000000000SSSSSSSSSSSSSSSSSSSSSSSSS0000S
S000000000000000000SSSSSSSSSSSSSSSSSSSSS000000000000000000SSSSSSSSSSSSSSSSSSSSSSSS00000S
S000000000000000000SSSSSSSSSSSSSSSSSSSSS000000000000000000SSSSSSSSSSSSSSSSSSSSSSS000000S
S000000000000000000SSSSSSSSSSSSSSSSSSSSS000000000000000000000000000000000000SSSS0000000S
S0000P0000000000000SSSSSSSSSSSSSSSSSSSSS000000000000000000SSSSSSSSSSSSSSSSS0SSS00000000S
S000000000000000000SSSSSSSSSSSSSSSSSSSSS000000000000000000SSSSSSSSSSSSSSSSS0SS0000000000
S000000000000000000SSSSSSSSSSSSSSSSSSSSS000000000000000000SSSSSSSSSSSSSSSSS0S0000000000S
S000000000000000000000000000000000000000000000000000000000SSSSSSSSSSSSSSSSS000000000000S
S000000000000000000SSSSSSSSSSSSSSSSSSSSS000000000000000000SSSSSSSSSSSSSSSSSSS0000000000S
S000000000000000000SSSSSSSSSSSSSSSSSSSSS000000000000000000SSSSSSSSSSSSSSSSSSSS000000000S
SSSSSSSSSSSSSSSSSSSSSSSSSSSSSSSSSSSSSSSSSSSSSSSSSSSSSSSSSSSSSSSSSSSSSSSSSSSSSSSSSSSSSSSS