SSSSSSSSSSSSSSSSSSSSSSSSSSSSSSSSSSSSSSSSSSSSSSSSSSSSSSSSSSSSSSSSSSSSSSSSSSSSSSS
S000000000000000000SSSSSSSSSSSS000000000000000000SSSSSSSSSSSSS000000000000000SS
S000000000000000000SSSSSSSSSSSS000000000000000000SSSSSSSSSSSSS000000000000000SS
S0000000000000000000000000SSSSS000000000000000000SSSSSSSSSSSSS000000000000000SS
S000000000000000000SSSSSS0SSSSS000000000000000000SSSSSSSSSSSSS000000000000000SS
S000000000000000000SSSSSS0SSSSS000000000000000000SSSSSSSS00000000000000000000SS
S000000000000000000SSSSSS0SSSSS000000000000000000SSSSSSSS0SSSS000000000000000SS
S000000000000000000SSSSSS000000000000000000000000SSSSSSSS0SSSS000000000000000SS
S00000000P000000000SSSSSSSSSSSS000000000000000000SSSSSSSS0SSSS00000000000000000
S000000000000000000SSSSSSSSSSSS000000000000000000SSSSSSSS0SSSS000000000000000SS
S000000000000000000SSSSSSSSSSSSSSSSSSSSSSSSSS0SSSSSSSSSSS0SSSS000000000000000SS
S000000000000000000SSSSSSSSSSSS000000000000000000SSSSSSSS0SSSS000000000000000SS
S000000000000000000SSSSSSSSSSSS000000000000000000000000000SSSS000000000000000SS
S000000000000000000SSSSSSSSSSSS000000000000000000SSSSSSSSSSSSS000000000000000SS
SSSSSSSSSSSSSSSSSSSSSSSSSSSSSSSSSSSSSSSSSSSSSSSSSSSSSSSSSSSSSSSSSSSSSSSSSSSSSSS