SSSSSSSSSSSSSSSSSSSSSSSSSSSSSSSSSSSSSSSSSSSSSSSSSSSSSSSSSSSSSSSSSSSSSSSSSSSSSSSSSSSSSSSSSSSSSSSSSSSSSSSSSSSSSS
S000000000000000000SSSSSSSSSSSS000000000000000000SSSSSSSSSSSSS000000000000000SSSSSSSSSSSSSSS00000000000000000S
S000000000000000000SSSSSSSSSSSS000000000000000000SSSSSSSSSSSSS000000000000000SSSSSSSSSSSSSSS00000000000000000S
S0000000000000000000000000SSSSS000000000000000000SSSSSSSSSSSSS000000000000000SSSSSSSSSSSSSSS00000000000000000S
S000000000000000000SSSSSS0SSSSS000000000000000000SSSSSSSSSSSSS000000000000000SSSSSSSSSSSSSSS00000000000000000S
S000000000000000000SSSSSS0SSSSS000000000000000000SSSSSSSS00000000000000000000SSSSSSSSSSSSSSS000000000000000000
S000000000000000000SSSSSS0SSSSS000000000000000000SSSSSSSS0SSSS000000000000000SSSSSSSSSSSS00000000000000000000S
S000000000000000000SSSSSS000000000000000000000000SSSSSSSS0SSSS000000000000000SSSSSSSSS0000SS00000000000000000S
S00000000P000000000SSSSSSSSSSSS000000000000000000SSSSSSSS0SSSS0000000000000000000000000SSSSS00000000000000000S
S000000000000000000SSSSSSSSSSSS000000000000000000SSSSSSSS0SSSS000000000000000SSSSSSSSSSSSSSS00000000000000000S
S000000000000000000SSSSSSSSSSSSSSSSSSSSSSSSSS0SSSSSSSSSSS0SSSS000000000000000SSSSSSSSSSSSSSS00000000000000000S
S000000000000000000SSSSSSSSSSSS000000000000000000SSSSSSSS0SSSS000000000000000SSSSSSSSSSSSSSS00000000000000000S
S000000000000000000SSSSSSSSSSSS000000000000000000000000000SSSS000000000000000SSSSSSSSSSSSSSS00000000000000000S
S000000000000000000SSSSSSSSSSSS000000000000000000SSSSSSSSSSSSS000000000000000SSSSSSSSSSSSSSS00000000000000000S
SSSSSSSSSSSSSSSSSSSSSSSSSSSSSSSSSSSSSSSSSSSSSSSSSSSSSSSSSSSSSSSSSSSSSSSSSSSSSSSSSSSSSSSSSSSSSSSSSSSSSSSSSSSSSS