SSSSSSSSSSSSSSSSSSSSSSSSSSSSSSSSSSSSSSSSSSSSSSSSSS
S000000000000000000SSSSSSSSSSSS000000000000000000S
S000000000000000000SSSSSSSSSSSS000000000000000000S
S0000000000000000000000000SSSSS000000000000000000S
S000000000000000000SSSSSS0SSSSS000000000000000000S
S000000000000000000SSSSSS0SSSSS000000000000000000S
S000000000000000000SSSSSS0SSSSS000000000000000000S
S000000000000000000SSSSSS000000000000000000000000S
S00000000P000000000SSSSSSSSSSSS000000000000000000S
S000000000000000000SSSSSSSSSSSS000000000000000000S
S000000000000000000SSSSSSSSSSSSSSSSSSSSSSSSSS0SSSS
S000000000000000000SSSSSSSSSSSS000000000000000000S
S000000000000000000SSSSSSSSSSSS000000000000000000S
S000000000000000000SSSSSSSSSSSS000000000000000000S
SSSSSSSSSSSSSSSSSSSSSSSSSSSSSSSSSSSSSSSSSSSSSSSSSS